,full_path,file_name,lines_of_code,lines_of_text,verb_count,wccs,avg_wcc_size,code_text_ratio,quartile
0,../reproducibility-notebooks/00/0854decbdd05a329a9cce2fc3aa449698e2768/While loops.ipynb,While loops.ipynb,768,2111,13,[],0.0,-1343,Q1
1,../reproducibility-notebooks/00/89857aeaf2ffca6b3ea21bf69ea23fd8356111/regression/.ipynb_checkpoints/Untitled4-checkpoint.ipynb,Untitled4-checkpoint.ipynb,0,0,0,[],0.0,0,Q1
2,../reproducibility-notebooks/00/91eeda481190f090d3d9fb8c222d1961732648/Week3/ex1.ipynb,ex1.ipynb,274,0,0,"[{'word', 'SparkContext', 'x', 'file_name', 'len', 'word_map', 'sc'}]",7.0,274,Q1
3,../reproducibility-notebooks/00/10d3e425a8e560a93d47cdfae1e2a67a412d4a/Pandas-Exercises/04_Apply/.ipynb_checkpoints/Exercises4-checkpoint.ipynb,Exercises4-checkpoint.ipynb,0,925,23,[],0.0,-925,Q2
4,../reproducibility-notebooks/00/87d6ca2c414d083309c82f24b610da6cb87ccc/notebook/20161115_importData.ipynb,20161115_importData.ipynb,3366,130,46,"[{'INPATTERN'}, {'OUTFORMAT', 'plt', 'ymin', 'outpattern', 'yoffset', 'filename', 'ymax', 'image', 'xmax', 'basename', 'img', 'os', 'xmin', 'xoffset', 'dirname'}, {'xoffsets'}, {'yoffsets'}]",4.5,3236,Q2
5,../reproducibility-notebooks/00/c357f0c9623ab3084ddd1fb78c64add7c2ab64/projects/practice_projects/cnn/mnist-mlp/mnist_mlp.ipynb,mnist_mlp.ipynb,2859,664,41,"[{'i', 'ax', 'plt', 'fig'}, {'img', 'thresh'}, {'Sequential', 'np_utils', 'accuracy', 'y_train', 'ModelCheckpoint', 'X_train', 'X_test', 'y_test', 'model', 'hist', 'score', 'checkpointer'}]",6.0,2195,Q2
6,../reproducibility-notebooks/00/ac9be355f0471ea35fc5d6594338c08c86c841/src/splitXgBootst.ipynb,splitXgBootst.ipynb,10035,0,97,"[{'is_valid'}, {'directories', 'y', 'test_columns', 'lines', 'np', 'pred', 'test', 'subtrainname', 'y1', 'ip_count', 'path', 'dt', 'y2', 'datetime', 'iteration', 'subpath', 'pd', 'dtest', 'picpath', 'range', 'skiplines', 'str', 'almostone', 'skiprows', 'subtrain', 'logit', 'subname', 'sub', 'xgb', 'modelpath', 'nrow_train', 'nDimSample', 'output', 'modelname', 'x1', 'model', 'timeFeatures', 'train_columns', 'input', 'dtraintest', 'params', 'dvalid', 'dtrain', 'x2', 'almostzero', 'dtypes', 'watchlist', 'merge', 'train'}, {'start_time', 'time'}, {'subfilenames'}, {'modelfiles'}, {'count'}, {'tag'}, {'linear_model', 'clf'}]",7.25,10035,Q3
7,../reproducibility-notebooks/00/8c55d4cae6324874b7a316b39f3b383bf78b58/Basics.ipynb,Basics.ipynb,6471,951,77,"[{'DataFrame', 'close_px', 'np', 'get_beta', 'read_csv', 'Series', 's1', 'grouped', 'range', 'randn', 'x', 'n', 'index', 'mapping', 'DateRange', 'df2', 'hdf', 'rets', 'beta_by_ym', 'tuples', 'model', 's', 'sm', 'MultiIndex', 'columns', 'zip', 'df', 'foo', 'labels', 's2'}, {'data'}]",15.5,5520,Q3
8,../reproducibility-notebooks/00/12db98d593c772e04fe551d3e3d4de87743a90/02-Python Statements/01-Introduction to Python Statements.ipynb,01-Introduction to Python Statements.ipynb,0,2213,54,[],0.0,-2213,Q3
9,../reproducibility-notebooks/00/37f8a7e5914d0d4408a47e37e433f0c138da97/PrisonersDilemma/experiment3/Experiment-2015-11-30.ipynb,Experiment-2015-11-30.ipynb,29446,84477,486,"[{'self', 'Strategy', 'S', 'rst'}, {'TestStrategies', 'suite', 'unittest'}, {'Strategy5', 'ts_length', 'float', 'max_ts', 'Strategy24', 'pd', 'ALLD', 'prob', 'MyStrategy', 'stds', 'averages', 'PubStrategy', 'rounds', 'int', 'Self_Centered_perfect', 'Strategy15', 'sigma', 'OyamaImperfectPrivateMonitoring', 'old_s', 'Strategy1', 'Strategy6', 'bp', 'np', 'private_signal', 'pl', 'ImPrivStrategy', 'ax', 'str', 'Iida_ipm', 'payoff', 'Strategy4', 'upper_b', 'beeleb', 's', 'lower_b', 'Strategy14', 'seed', 'Strategy9', 'Strategy3', 'Iida_iprm', 'size', 'OyamaImperfectPublicMonitoring', 'yamagishi', 'Iida_pm', 'Strategy10', 'rs', 'Strategy19', 'Strategy20', 'Strategy12', 'ogawa', 'average_matrix', 'Strategy2', 'df_t', 'range', 'Strategy16', 'Strategy13', 'discount_v', 'width', 'game', 'GrimTrigger', 'Self_Centered_public', 't_list', 't', 'average', 'Strategy7', 'public_signal', 'strategies', 'WSLS', 'trimmed_ts_length', 'ImPubStrategy', 'Strategy18', 'Strategy23', 'Strategy17', 'Strategy8', 'ordered_df', 'x', 'OyamaPerfectMonitoring', 'Strategy22', 'mu', 'Strategy11', 'KatoStrategy', 'p', 'i', 'ranking', 'Self_Centered_private', 'TFT', 'df', 'Strategy21', 'random_state', 'average_list'}, {'repeat'}, {'pattern'}, {'signal_probs'}, {'hist'}, {'total'}]",12.75,-55031,Q4
10,../reproducibility-notebooks/00/5f3635f22300a3e2e081eb3ffb3b37dcf01dc0/khy_test_up1_eye_0.ipynb,khy_test_up1_eye_0.ipynb,6351,1056,140,"[{'open', 'f1'}, {'latter_v', 'vertical_pos', 'repr', 'i', 'latter_h', 'tintinPivot', 'str', 'lines', 'horizontal_pos', 'j', 'former_v', 'traceName', 'data', 'initial_timestamp', 'former_h'}, {'theta_vel_layout', 'theta_data', 'phi_figure', 'phi_vel_trace', 'vection', 'vertical_pos_layout', 'vertical_pos_figure', 'vertical_pos_trace', 'dict', 'theta_trace', 'horizontal_pos_trace', 'horizontal_pos_figure', 'horizontal_pos_data', 'phi_vel_data', 'timestamp', 'theta_figure', 'vertical_pos_data', 'theta_layout', 'phi_vel_figure', 'vection_trace', 'phi_vel_layout', 'phi_layout', 'theta_vel_figure', 'phi_trace', 'phi_data', 'theta_vel_data', 'theta_vel_trace', 'horizontal_pos_layout', 'go'}, {'count'}, {'angular_vector'}, {'theta'}, {'phi'}, {'theta_vel'}, {'phi_vel'}]",5.777777777777778,5295,Q4
11,../reproducibility-notebooks/00/58d879dbc0f3af2deed65ad49a234306a41fcc/model_bbox/resnet50_FT38_Classifier_Rep4/Classifier_rep4.ipynb,Classifier_rep4.ipynb,32140,0,353,"[{'TRAIN_DIR'}, {'GTbbox_df', 'test_pred_T_df', 'y', 'OUTPUT_DIR', 'float', 'basename', 'path', 'CHECKPOINT_DIR', 'COLS', 'pd', 'fish', 'X_valid', 'index_RFCN', 'model_name', 'datagen', 'min', 'files', 'current_index', 'json', 'j', 'detects_im', 'bboxes', 'f', 'index', 'train_pred', 'int', 'test_pred_im_df', 'model', 'test_pred_T_array', 'FISH_CLASSES', 'data', 'test_pred_im_clsMax_array', 'current_batch_size', 'GTbbox_CROPpred_fish_df', 'steps_per_epoch', 'batch_df', 'predictions', 'submission', 'Model', 'filename', 'np', 'Dense', 'cropped', 'valid_pred', 'test_pred_array', 'c', 'preprocess_input', 'ymin', 'CROPpred_df', 'math', 'mean', 'image_logloss', 'featurewise_center', 'logloss', 'data_trainfish', 'data_test', 'score_CROP', 'class_weight_fish', 'X_train_centered', 'y_train', 'batch_x', 'pickle', 'ImageDataGenerator', 'model_checkpoint', 'valid_logloss_df', 'RFCN', 'ModelCheckpoint', 'class_RFCN', 'TensorBoard', 'test_aug_datagen', 'len', 'img', 'RFCNbbox_RFCNpred_df', 'test_size', 'train_files', 'x_centered', 'X_trainfish_crop', 'xmax', 'train_detections_full_AGNOSTICnms', 'K', 'batch_index', 'data_train', 'GlobalAveragePooling2D', 'crop_classes', 'class_CROP', 'TEST_DIR', 'base_model', 'ResNet50', 'batch_size', 'test_mean', 'checkpoint_dir', 'im', 'X', 'RFCN_MODEL', 'y_valid', 'index_CROP', 'bbox', 'sub_file', 'LOG_DIR', 'load_img', 'width', 'load_model', 'train_logloss', 'max_cls', 'image_class', 'T', 'open', 'image_file', 'row', 'Image', 'l', 'test_model_name', 'a', 'CROP', 'BATCHSIZE', 'time', 'detections_full_AGNOSTICnms', 'test_pred_df', 'CROP_MODEL', 'RFCNbbox_RFCNpred_CROPpred_HYBRIDpred_df', 'X_train', 'pred', 'train_file_labels', 'idx', 'num_NoF', 'train_datagen', 'dict', 'ind', 'test_preds', 'name', 'X_valid_centered', 'image_name', 'max', 'x', 'n', 'tensorboard', 'GTbbox_CROPpred_df', 'height', 'X_test_crop', 'xmin', 'train_generator', 'ref', 'num_NoF_perIm', 'test_pred_im_clsMaxAve', 'i', 'RFCN_dets', 'GT_dets', 'test_files', 'test_pred_im_clsMax_df', 'test_model', 'ymax', 'file_name', 'image', 'max_score', 'glob', 'CONF_THRESH', 'count', 'train_logloss_df', 'df', 'val_losses', 'train_mean', 'target_size', 'ROWS', 'score_RFCN', 'test_generator'}, {'TRAIN_CROP_DIR'}, {'TEST_CROP_DIR'}, {'optimizer', 'LEARNINGRATE', 'Adam'}, {'class_weight'}, {'EarlyStopping', 'early_stopping'}, {'ReduceLROnPlateau', 'learningrate_schedule'}, {'start_layer'}, {'nb_augmentation'}]",17.8,32140,Q4
